[
  {
    "Id": 50000000,
    "Owner": 0,
    "Desc": "一个测试卡组",
    "CharaList": [
      10000000,
      10000001,
      10000000,
      10000001
    ],
    "CardList": [
      12000000,
      12000001,
      12000002,
      12000003,
      12000004,
      12000005,
      12000006,
      12000007,
      13000000,
      13000001,
      13000002,
      13000003,
      13000004,
      13000005,
      13000006,
      13000007,
      13000008,
      13000009,
      13000010,
      13000011,
      12000008,
      12000009,
      12000010
    ]
  },
  {
    "Id": 50000001,
    "Owner": 0,
    "Desc": "二个测试卡组",
    "CharaList": [
      10000000,
      10000001,
      10000000,
      10000001
    ],
    "CardList": [
      12000000,
      12000001,
      12000002,
      12000003,
      12000004,
      12000005,
      12000006,
      12000007,
      13000000,
      13000001,
      13000002,
      13000003,
      13000004,
      13000005,
      13000006,
      13000007,
      13000008,
      13000009,
      13000010,
      13000011
    ]
  },
  {
    "Id": 50000002,
    "Owner": 0,
    "Desc": "三个测试卡组",
    "CharaList": [
      10000000,
      10000001,
      10000002,
      10000003
    ],
    "CardList": [
      12000000,
      12000001,
      12000002,
      12000003,
      12000004,
      12000005,
      12000006,
      12000007,
      12000008,
      12000009,
      12000010,
      13000000,
      13000001,
      13000002,
      13000003,
      13000004,
      13000005
    ]
  }
]